12 10
**********
*        *
*   **@* *
* * ** * *
* ****** *
*   **   *
* *    ***
* ** * ***
* *  * * *
* * ** * *
*   **   *
******#***